7
7
4
1111111
1173711
1633361
1336331
1371731
1371731
1111111
1111111
11   11
1     1
1     1
1  1  1
1  3  1
1111111
1111111
13   31
1    41
1     1
1  3  1
1     1
1111111
1111111
1746471
1444411
1744471
1444441
1746471
1111111