64
64
111111111111111111111111111
1                 4       1
1 4 4 4 4 4 4 4 4 4 4 4 4 1
1                         1
1  3     22222   4        1
1        2       4        1
1  3     2       44444 4441
1  3   2222222       4    1
1            2            1
1444444444   2    222222221
14       4   2    2      21
14  222      2       44  21
14       4        2      21
1444444444        222222221
111111111111111111111111111


