7
7
4
1111111
1736371
1333331
1733371
1333331
1736371
1111111
1111111
1     1
1     1
1     1
1     1
1     1
1111111
1111111
1     1
1     1
1     1
1     1
1     1
1111111
1111111
1444441
1444441
1444441
1444441
1444441
1111111