5
5
1
11111
12521
15551
12521
11111