6
5
1
111111
125521
155551
125521
111111