10
10
1
1111111111
12      21
1        1
1 22 212 1
1 12 211 1
1 1   11 1
1 211 12 1
11 11    1
1  112  21
1111111111