6
5
3
111111
123321
133331
123321
111111
111111
13  31
1    1
13  31
111111
111111
144441
144441
144441
111111