6
5
4
111111
123321
133331
123321
111111
111111
13  31
1    1
13  31
111111
111111
14  41
1    1
14  41
111111
111111
124421
144441
124421
111111