10
10
3
1111111111
1313333331
1313313331
1313313331
1313313331
1313313331
1311113331
1333333331
1333333331
1111111111
1111111111
1 3      1
1 3  1   1
1 3  3   1
1 3  3   1
1 3  3   1
1 3333   1
1        1
1        1
1111111111
1111111111
1444444441
1444414441
1444444441
1444444441
1444444441
1444444441
1444444441
1444444441
1111111111