7
7
4
1111111
1636361
1333331
1333331
1333331
1333331
1111111
1111111
1     1
1     1
1     1
1     1
1     1
1111111
1111111
1     1
1     1
1     1
1     1
1     1
1111111
1111111
1444441
1444441
1444441
1444441
1646461
1111111