10
10
3
1111111111
1312336321
1313313331
1313313331
1313313361
1312313331
1321123331
1633333331
1333336321
1111111111
1111111111
1 33    31
1 3  1   1
1 3  3   1
1 3  3   1
1 33 3   1
1 3333   1
1        1
1       21
1111111111
1111111111
1444446441
1644414441
1444444441
1444444461
1444444441
1444444441
1444444441
1444446421
1111111111