5
5
11111
15 21
1   1
1  31
11111