10
10
1111111111
15      21
1        1
1  314   1
1  111   1
1  215   1
1        1
1        1
14      31
1111111111