7
7
1
1111111
12   21
1     1
1  1  1
1     1
12   21
1111111