5
5
11111
1   1
1 1 1
1   1
11111