26
7
MMMMMMMMMMMMMMMMMMMMMMMMMM
M                        M
M   MMM      MMMMM   M   M
M   MMM      M   M   M   M
M   MMM      M   MMMMM   M
M                        M
MMMMMMMMMMMMMMMMMMMMMMMMMM