10
10
3
1111111111
1f1ffffff1
1f1ff1fff1
1f1ff1fff1
1f1ff1fff1
1f1ff1fff1
1f1111fff1
1ffffffff1
1ffffffff1
1111111111
1111111111
1 f      1
1 f  1   1
1 f  f   1
1 f  f   1
1 f  f   1
1 ffff   1
1        1
1        1
1111111111
1111111111
1cccccccc1
1cccc1ccc1
1cccccccc1
1cccccccc1
1cccccccc1
1cccccccc1
1cccccccc1
1cccccccc1
1111111111