7
7
4
1111111
1333331
1333331
1333331
1333331
1333371
1111111
1111111
1     1
1     1
1     1
1     1
1     1
1111111
1111111
1     1
1     1
1     1
1     1
1     1
1111111
1111111
1444441
1444441
1444441
1444441
1444441
1111111