10
10
1
1111111111
1       21
1        1
1 21 212 1
1 12 111 1
1 1   11 1
1 211 12 1
1  11    1
1  11    1
1111111111