7
7
1
1111111
1255521
1555551
1555551
1555551
1255521
1111111