7
7
1
1111111
1255551
1555551
1555551
1555551
1555551
1111111