5
5
1
11111
12321
13331
12321
11111