10
10
1111111111
1       21
1        1
1 310114 1
1 150111 1
1 100011 1
1 211015 1
1  11    1
1  11    1
1111111111